##########
#S       #
######## #
#E       #
##########
